NO ./path_to_the_north_texture
SO ./path_to_the_south_texture
WE ./path_to_the_west_texture
EA ./path_to_the_east_texture

F 220,100,0
C 225,30,0

1111
1001        11111
10001       10001
100001      11111
111011111
100000001
111111111
11111111
10S00001
11111111
