NO ./path_to_the_north_texture
SO ./path_to_the_south_texture
WE ./path_to_the_west_texture 
EA ./path_to_the_east_texture

F 220,100,awdawd
C 225,30,010

1111
1001        111111 
10001       100001   
10000111    100001    
10S000001   111111
111111111
