NO ./textures/Wall1.xpm
SO ./textures/Wall2.xpm
WE ./textures/Wall3.xpm
EA ./textures/Wall4.xpm

F 220,100,0
C 225,30,0

111111111111111111
100000000000000001
100010000000101001
100010000001001001
1000100S0010001001
100011111100001001
100000000000001001
111111111111111111
