NO ./textures/Wall1.xpm
SO ./textures/Wall2.xpm
WE ./textures/Wall3.xpm
EA ./textures/Wall4.xpm

F 220,100,0
C 225,30,0

11111 
11111111
10001
10S01
100001
1111111
111111
